乾	干
噹	当
復	复
徵	征
戰	战
瀋	沈
灠	漤
灡	㳕
瞭	了
線	线
緻	致
繡	绣
著	着
藉	借
蘋	苹
蘭	兰
裡	里
覆	覆
註	注
詠	咏
誌	志
謲	𬤄
譸	诪
譾	谫
買	买
賬	账
贓	赃
蹤	踪
輓	挽
鉤	钩
錶	表
鍾	钟
鏇	旋
鐫	镌
鑽	钻
開	开
閤	合
闆	板
闢	辟
靦	䩄
韆	千
韻	韵
願	愿
颱	台
餘	余
餚	肴
餱	糇
鱄	𫚋
鱨	鲿
鱷	鳄
鷿	䴙
鸒	𱊭
麯	曲
齣	出
